1 1 1 1 1 1 1 1 1 1 1 1 1 1 1 1 1 1 1 1 1 1 1 1 1 1 1 1 1 1 1 1 1 1 1 1 1 1 1 1 1 1 1 1 1 1 1 1 1 1 1
1 1 0 0 0 0 0 1 0 0 0 0 1 0 0 0 0 0 0 0 0 0 0 0 0 0 0 0 0 0 0 0 4 5 0 0 0 0 0 0 0 0 0 0 0 0 0 0 0 0 4
5 0 0 0 0 0 0 1 0 0 0 0 1 0 0 0 0 0 0 0 0 0 0 0 0 0 0 0 0 0 0 0 4 5 0 0 0 0 0 0 0 0 0 0 0 0 0 0 0 0 4
5 0 0 2 3 0 0 1 0 0 0 0 1 0 0 0 0 0 0 0 0 0 0 0 0 0 0 0 0 0 0 0 4 5 0 0 0 1 1 1 1 1 1 1 1 1 1 1 0 0 4
5 0 0 4 5 0 0 1 0 0 0 0 1 0 0 0 0 2 3 0 0 0 0 0 0 0 0 0 0 0 0 0 4 5 0 0 0 0 1 0 0 0 0 1 0 0 0 1 0 0 4
5 0 0 0 4 0 0 0 0 1 0 0 1 0 0 0 0 4 5 0 0 0 0 0 0 0 0 0 0 0 0 0 4 5 0 0 0 0 1 0 0 0 0 1 0 0 0 1 0 0 4
5 0 0 0 4 0 0 0 0 1 0 0 0 1 0 0 0 4 5 0 0 0 0 0 0 0 0 0 0 0 0 0 4 5 0 0 0 0 1 0 0 1 0 0 0 0 0 1 0 0 4
1 3 0 0 4 0 0 1 1 1 0 0 0 0 1 0 0 1 1 3 0 0 0 0 0 0 0 0 0 0 0 0 4 5 0 0 0 0 1 0 0 0 0 0 1 0 0 1 0 0 4
5 0 0 0 4 1 1 1 1 1 0 0 0 0 0 0 0 1 0 0 3 0 0 0 0 0 0 0 0 0 0 0 4 5 0 0 0 0 4 3 0 0 0 1 1 3 0 1 0 0 4
5 0 0 0 4 1 1 5 0 0 4 1 3 0 0 0 0 1 0 0 0 3 0 0 0 0 0 0 0 0 0 0 0 0 0 0 0 0 0 4 3 0 0 1 5 0 0 1 0 0 4
5 0 0 0 0 0 0 0 0 0 0 0 4 1 1 1 1 1 0 0 0 0 3 0 0 0 0 1 1 1 1 1 0 0 0 0 0 0 0 4 5 0 0 1 0 0 0 1 0 0 4
1 1 3 0 0 0 0 0 0 0 0 0 4 1 0 0 4 5 0 0 0 0 0 3 0 0 0 0 0 0 0 0 0 0 0 0 0 0 0 4 5 0 0 1 0 0 0 1 0 0 4
5 0 0 0 0 2 3 0 0 2 1 1 5 0 0 0 4 5 0 0 0 0 0 4 3 0 0 0 0 0 0 0 0 0 0 0 0 0 0 4 5 0 0 1 0 0 0 1 0 0 4
5 0 0 0 0 0 0 0 0 0 0 0 0 0 0 2 1 5 0 0 0 0 0 4 1 1 1 1 1 3 0 0 0 0 0 0 0 0 0 4 5 0 0 1 0 0 0 1 0 0 4
5 0 0 0 0 0 0 0 0 0 0 0 0 0 2 1 1 5 0 0 0 0 0 4 1 1 5 0 0 0 3 0 0 0 0 0 0 0 0 4 5 0 0 1 3 0 0 1 0 0 4
5 0 0 0 2 1 1 1 1 1 1 1 1 1 5 0 0 0 0 0 0 0 0 4 1 1 5 0 0 0 0 1 1 1 3 0 0 0 0 4 5 0 0 1 5 0 0 1 0 0 4
5 0 0 0 4 1 1 1 1 1 1 1 5 0 0 0 0 0 0 0 0 0 0 4 1 5 0 0 1 0 0 0 0 0 1 0 0 0 0 4 5 0 0 1 5 0 0 1 0 0 4
1 3 0 0 0 0 0 0 0 0 0 0 0 0 0 2 3 0 0 0 0 0 0 4 5 0 0 0 1 0 0 0 0 0 4 1 1 1 1 1 5 0 0 1 5 0 0 1 0 0 4
1 1 3 0 s 0 0 0 0 0 0 0 0 0 2 1 5 0 0 0 0 0 0 4 5 0 0 0 1 0 0 0 0 0 0 0 0 0 0 0 0 0 0 1 0 0 0 0 0 0 4
1 1 1 1 1 3 0 0 0 0 0 0 0 2 1 1 1 1 1 1 3 0 0 4 5 0 e 0 1 0 0 0 0 0 0 0 0 0 0 0 0 0 0 1 0 0 0 0 0 0 4
1 1 1 1 1 1 1 1 1 1 1 1 1 1 1 1 1 1 1 1 1 1 1 1 1 1 1 1 1 1 1 1 1 1 1 1 1 1 1 1 1 1 1 1 1 1 1 1 1 1 1